Kinase_RPS6KA4	Kinase_AURKB	Kinase_CSNK2A1	Kinase_CAMKK1
Kinase_PRKD2
Kinase_CDK1	Kinase_PLK1	Kinase_CDK2	Kinase_AURKA
Kinase_MAPKAPK2	Kinase_CHEK2
Kinase_NEK2
Kinase_SGK1	Kinase_MAP2K4
Kinase_BUB1	Kinase_RPS6KA6
Kinase_PKN2	Kinase_PRKCI	Kinase_PRKCD
Kinase_DYRK1A	Kinase_CDK5	Kinase_PTK2B
Kinase_MAP3K8	Kinase_WEE1	Kinase_PAK1
Kinase_BMX	Kinase_MET
Kinase_IKBKB	Kinase_CHUK	Kinase_PRKDC	Kinase_STK4
Kinase_ADRBK2
Kinase_HCK	Kinase_LYN	Kinase_SYK	Kinase_FGR	Kinase_FYN
Kinase_NTRK2	Kinase_NTRK1
Kinase_CSNK1G2	Kinase_CSNK1D
Kinase_BTK	Kinase_IGF1R
Kinase_TRPM7
Kinase_PRKACG	Kinase_PRKACB	Kinase_PRKX
Kinase_NLK	Kinase_STK11	Kinase_TGFBR1
